################################
#.....#.........#.....#........#
#.###.#.###.###.#.###.#.##.##..#
#..............................#
#.###.##.#####.####.#####.#.##.#
#.###.##...###.####.#####.#.##.#
#.###.####................#.##.#
#.....########.######.###.#....#
###.#.########.######.###.#.#..#
#...#.####.........##.....#....#
#.#.#.####.###.###.##.###.###..#
#.....####.#..$$.#....###.###..#
#####.####.#..$$.#.######......#
#####......#######........####.#
#####.###.....@....##.###.####.#
#.....###.###.###.###.###.####.#
#.###.###.###.###.###.###.####.#
#.###.##...#...#......#........#
#..##.#..#...#...####.#.#####..#
##.##.#.###.####.####.#.###....#
#...........................#..#
#.###.#.###.###.#.###.#.##.##..#
#.....#.........#.....#........#
################################