################################
#......#.#............#.#......#
#.####.#.#.##########.#.#.####.#
#...#..#................#..#...#
###.#.##.####.####.####.##.#.###
#...........#......#...........#
#.###.#####.##.##.##.#####.###.#
#...........#......#...........#
#.###.#.#.#...####...#.#.#.###.#
#...#.#.#.#.###..###.#.#.#.#...#
###.#.#...#...#..#...#...#.#.###
#...#...###.#.####.#.###...#...#
#.#.###.#...#......#...#.###.#.#
#.........#...####...#.........#
####.######################.####
#.............#..#.............#
#.#######.#.#.#..#.#.#.#######.#
#.........#.#......#.#.........#
#########.#.#.####.#.#.#########
#.........#..........#.........#
#.##.###.#####.##.#####.###.##.#
#.#..#....#..........#....#..#.#
#.#....#....#......#....#....#.#
################################
