################################
#.........#..........#.........#
#.#######.#.####...#.#.###.###.#
#...........#....###...###.###.#
#.####.####...##.#...#.##...##.#
#.........#.##...#.#.#.##.#.##.#
###.###.#.#...##.#...#.##.#.##.#
#.........#.##...###.#....#....#
#.###.#####..###...#.#.##...##.#
#.........#....###...#.##.#.##.#
###.#####......@.###......#....#
#.........#....###...#.#..######
#.##.#.####..###...#.#.#..##$$.#
#...........##...#.#...#..##$$.#
#.#######.#.....##...#....######
#.........#.###.####.#.##......#
###.###.###.#......#.#.###.###.#
#.........#.#.####.#.#.#.#.#.#.#
#.#.#####.#...####...#.#.....#.#
#.........#.#.####.#.#...#.#...#
#####.###...#......#...##...##.#
#.........#.###.####.#.###.###.#
###########..........#.........#
################################
