################################
#.........#..........#.........#
#.#######.#.####...#.#.###.###.#
#...........#....###...###.###.#
#.####.####...##.#...#.##...##.#
#.........#.##...#.#.#.##.#.##.#
###.###.#.#...##.#...#.##.#.##.#
#.........#.##...###.#....#....#
#.###.#####..###...#.#.##...##.#
#.........#....###...#.##.#.##.#
###.#####........###......#....#
#.........#....###...#.#.###.###
#.##.#.####..###...#.#.#.###.###
#...........##...#.#...#.###.###
#.#######.#.....##...#....#....#
#.........#.###.####.#.##...##.#
###.###.###.#......#.#.###.###.#
#.........#.#.####.#.#.#.#.#.#.#
#.#.#####.#...####...#.#.....#.#
#.........#.#.####.#.#...#.#...#
#####.###...#......#...##...##.#
#.........#.###.####.#.###.###.#
###########..........#.........#
################################