################################
#.....#....$....#.....#........#
#.###.#.###.###.#.###.#.##.##..#
#..............................#
#.###.##.#####.####.#####.#.##.#
#.###.##...###.####.#####.#.##.#
#.###.####................#.##.#
#.....########.######.###.#.$..#
###.#.########.######.###.#.#..#
#...#.####.........##.....#....#
#.#.#.####.##.#.##.##.###.###..#
#.....####.#..#..#....###.###..#
#####.####.##....#.######......#
#####....$.###.###.....$..####.#
#####.###..........##.###.####.#
#..$..###.###.###.###.###.####.#
#.###.###.###.###.###.###.####.#
#.###.##...#...#......#.....$..#
#..##.#..#...#...####.#.#####..#
##.##.#.###.####.####.#.###....#
#...........................#..#
#.###.#.###.###.#.###.#.##.##..#
#.....#......@..#.....#........#
################################