################################
#.....#....$....#.....#........#
#.###.#.###.###.#.###.#.##.##..#
#..............................#
#.###.##.#####.####.#####.#.##.#
#.###.##...###.####.#####.#.##.#
#.###.#..#................#.##.#
#.....#.######.######.###.#.$..#
###.#.#.######.######.###.#.#..#
#...#...##.........##.....#....#
#.#.#.####.##.#.##.##.###.###..#
#.....####.#..#..#....###.###..#
#####.####.##....#.######......#
#####....$.###.###.....$..####.#
#####.###..........##.###....#.#
#..$..###.###.###.###.###.##...#
#.###.###.###.###.###.###.####.#
#.###.##...#...#......#.....$..#
#..##.#..#...#...####.#.#####..#
##.##.#.###.####.####.#.###....#
#...........................#..#
#.###.#.###.###.#.###.#.##.##..#
#.....#......@..#.....#........#
################################