################################
#......#.#.....$......#.#......#
#.####.#.#.##########.#.#.####.#
#...#..#................#..#...#
###.#.##.####.####.####.##.#.###
#....$......#......#....$......#
#.###.#####.##.##.##.#####.###.#
#...........#......#...........#
#.###.#.#.#...#..#...#.#.#.###.#
#...#.#.#.#.########.#.#.#.#...#
###.#.#...#..........#...#.#.###
#...#...###.#.####.#.###...#...#
#.#.###.#...#...@..#...#.###.#.#
#.........#...####...#.........#
####.######################.####
#...$.........#..#......$......#
#.#######.#.#.#..#.#.#.#######.#
#.........#.#......#.#.........#
#########.#.#.####.#.#.#########
#.........#..........#.........#
#.##.###.#####.##.#####.###.##.#
#.#..#....#....$.....#....#..#.#
#.#....#....#......#....#....#.#
################################
