################################
#.........#..........#....$....#
#.#######.#.####...#.#.###.###.#
#....$......#....###...###.###.#
#.####.####...##.#...#.##...##.#
#.........#.##...#.#.#.##.#.##.#
###.###.#.#...##.#...#.##.#.##.#
#.........#.##...###.#....#....#
#.###.#####..###...#.#.##...##.#
#.........#....###...#.##.#.##.#
###.#####......@.###......#....#
#.........#....###...#.#.###.#.#
#.##.#.####..###...#.#.#.###.#.#
#...........##...#.#...#.###.#.#
#.#######.#.....##...#....#....#
#....$....#.###.####.#.##..$...#
###.###.###.#...$..#.#.###.###.#
#.........#.#.####.#.#.#.#.#.#.#
#.#.#####.#...####...#.#.....#.#
#.........#.#.####.#.#...#.#...#
#####.###...#......#...##...##.#
#.........#.###.####.#.###.###.#
###########..........#....$....#
################################
